NO test.xpm
SO test.xpm
WE test.xpm
EA test.xpm

F 64,160,0
C 253,204,252

11111111111111111111
101010111000000011111
101000001010010000S1
 11111111110111111111
 11111111111111111111
