NO test.xpm
SO test.xpm







WE                   test.xpm





EA test.xpm


C 253,204,252
 64,160,0

11111111111111111111
101010111000000011111       111                
10100000101001000001        101       
11111111111111111111        111            
           1
 1111111111S111111111
 11111111111111111111           
