NO textures/wet_sponge.xpm
SO textures/wet_sponge.xpm
WE textures/wet_sponge.xpm
EA textures/wet_sponge.xpm

F 64,160,0
C 153,204,252


111111111111111111111
101010111000000011111
10100S001011111000001
11111111111   1111111
1