NO textures/wet_sponge.xpm
SO textures/wet_sponge.xpm
WE textures/wet_sponge.xpm
EA textures/wet_sponge.xpm

F 164,169,20
C 153,204,255

111111111111111111111
101010111000000011111
1N1000001011111000001
11111111111   1111111

