NO North.xpm
SO South.xpm
WE West.xpm
EA East.xpm


C 253,204,252
F 64,160,0

11111111111111111111
101010111000000011111111
10100000101001000001101
11111111111011111111111
 1111111111N111111111
 11111111111111111111