11111111111111111111111111111111111111
10000000000C00000000000C0000000000C001
10000P00000000000000000000E00000000001
10000000000000000011111000000000000001
10000000000C0000001C000000000C00000001
10000C000000000000111110000000000C0001
11111111111111111111111111111111111111